stress	STATE
obey	OBEY
destabilize	UBIQUITINATE
elevate	PLOT
desensitize	COUPLE
harbor	SEEK
modify	PROTEIN
detect	SEEK
term	ASPHYXIATE
reveal	SEEK
localize	CODIFY
connect	LABEL
metabolize	BRANCH
discover	TRACK
refute	REFUTE
impact	DIVERSIFY
scrutinize	SCRUTINIZE
complete	SIGN
transform	PATIENT
force	FRACTIONATE
shed	CAST
restore	PROTEIN
stage	STAGE
detail	DETAIL
reach	PATIENT
secrete	SIGN
resume	SEEDLE
call	ANNOTATE
pool	PROJECT
finalize	CO-WRITE
segregate	HOST
detoxify	DEUBIQUITINATE
interrupt	OVERLIE
mobilize	MOBILIZE
tell	ALERT
twitch	TWITCH
experience	SURVIVE
exaggerate	EXAGGERATE
track	TRACK
retrieve	SUBMIT
stand	NUCLEOTIDE
escape	EVADE
subclon	SUBCLON
impute	IMPUTE
bridge	BRIDGE
rinse	RESPOND
share	TRACK
store	DONATE
quench	QUENCH
decrease	ORCHESTRATE
specialize	SPECIALIZE
band	BAND
various	VARIOUS
extrapolate	EXTRAPOLATE
underline	ACCENTUATE
solubilize	DEFORM
convert	UBIQUITINATE
modulate	ORCHESTRATE
aggravate	AGGRAVATE
decode	DECODE
score	SALT
research	RESEARCH
direct	BLUNT
undertake	MOTIVATE
compare	COLLATE
ascend	ASCEND
impede	SEEDLE
minimize	OVERCOME
warrant	MOTIVATE
evaluate	EXPLOIT
normalize	PROJECT
dampen	DAMPEN
hydrolyse	HYDROLYSE
deepen	DEEPEN
treat	VISIT
synthesise	SYNTHESISE
acknowledge	ACKNOWLEDGE
play	CONTRADICT
possess	INACTIVATE
ameliorate	GENERALISE
reconstruct	DENY
compose	CO-WRITE
accept	DONATE
process	CROSS-REACT
tackle	TACKLE
generalize	GENERALISE
distinguish	SIGN
mature	MATURE
calibrate	SPIN
push	OBEY
inform	SIGN
amino	PERCEIVE
antagonize	OVERRIDE
enrol	VISIT
offset	OFFSET
debilitate	BURN
know	PROJECT
telomere	TELOMERE
arise	ARISE
handle	DONATE
prune	DILATE
document	REEVALUATE
arrange	ARRANGE
govern	HINDER
recapitulate	ACCENTUATE
block	BIOTINYLATE
mount	BLUNT
await	OMIT
overcome	OVERCOME
locate	JUXTAPOSE
engage	COUPLE
cast	CAST
exemplify	EXEMPLIFY
similar	SIMILAR
confound	HINDER
highlight	OVERCOME
odds	PLOT
pursue	OMIT
fall	FALL
uncouple	UNCOUPLE
cluster	DONATE
question	QUESTION
incur	INCUR
preserve	DIVERSIFY
presume	PRESUME
judge	JUDGE
destabilise	DESTABILISE
screen	VISIT
separate	LABEL
declare	APPROACH
nucleate	NUCLEATE
taurus	TAURUS
summarize	PATIENT
intersperse	INTERSPERSE
continue	TAILOR
filter	ANNOTATE
synthesize	UBIQUITINATE
stabilise	STABILISE
different	DIFFERENT
cooperate	COOPERATE
manifest	SIGN
replace	JUXTAPOSE
assay	OVERRIDE
speed	EXPEDITE
constitute	EVADE
expand	PROJECT
double	FACE
integrate	CAST
sensitize	STAGE
shift	PLOT
elucidate	EVADE
encounter	RESPOND
prolong	PROLONG
curate	CURATE
mutate	OCCUPY
strike	STRIKE
accomplish	ACCOMPLISH
up-regulate	DIVERSIFY
deplete	LABEL
hypothesize	HYPOTHESIZE
permute	CLOT
delay	GENERALISE
measure	PROTEIN
parse	PARSE
randomize	RANDOMIZE
pull	PULL
reside	RESIDE
iron	IRON
fulfill	IMPAIRED
inspect	INSPECT
comprise	CODIFY
reflect	TRACK
assign	JUXTAPOSE
consolidate	CONSOLIDATE
complicate	HINDER
underestimate	OVERESTIMATE
sleep	DEVASTATE
recognise	RECOGNISE
explore	BRIDGE
alter	ORCHESTRATE
intervene	SUBMIT
join	SALT
catalogue	CATALOGUE
decide	DECIDE
receive	PATIENT
update	CONSULT
transcribe	DIVERSIFY
sample	ENLARGE
refer	CONSULT
recur	RECUR
translate	RECONCILE
suppress	SWITCH
move	MOVE
thank	THANK
saturate	SATURATE
reinforce	SPECULATE
normal	IMPAIRED
break	IMPAIRED
traverse	DEFORM
bypass	NECROTIZE
salt	SALT
permit	EVADE
restrict	PULL
hide	TRAIN
reassess	REASSESS
overlap	OCCUPY
redirect	REDIRECT
enable	MOTIVATE
retain	PROTEIN
turn	UPSLANT
compete	COMPETE
impart	FACE
duplicate	JUXTAPOSE
download	SUBMIT
neutralize	OMIT
attempt	COMMIT
resuspend	FRACTIONATE
edit	SUBMIT
hamper	HINDER
amplify	SWITCH
multiply	THANK
require	BRIDGE
delete	OCCUPY
participate	VISIT
terminate	TERMINATE
deteriorate	DETERIORATE
discuss	OVERCOME
ignore	IGNORE
decipher	SPECULATE
induce	INACTIVATE
respond	RESPOND
undermine	UNDERMINE
lend	RESEARCH
reevaluate	REEVALUATE
supply	DONATE
grade	GRADE
weaken	HINDER
adopt	STAGE
contrast	RECONCILE
broaden	ENLARGE
reanalyze	CONSULT
violate	OBEY
effect	EFFECT
blister	DEVASTATE
develop	BIOTINYLATE
accelerate	HEAR
engineer	TRAIN
appreciate	APPRECIATE
understand	SWITCH
override	OVERRIDE
confirm	COLLATE
inflate	INFLATE
augment	OVERRIDE
uncover	JUXTAPOSE
harbour	INACTIVATE
fine-map	DEMARCATE
administer	ADMINISTER
threaten	THREATEN
blur	BLUR
stratify	STAGE
serve	REEVALUATE
methylate	BURY
exploit	EXPLOIT
luteinize	COUPLE
solve	OVERCOME
divide	STAGE
overproduce	OVERPRODUCE
point	WALK
devise	SALT
re-evaluate	RE-EVALUATE
state	STATE
oversee	OVERSEE
sclerose	NECROTIZE
target	SWITCH
folate	IRON
intersect	INTERSECT
enrich	ENLARGE
immortalize	MATURE
delineate	OCCUPY
implement	SALT
convey	FACE
revert	AGGRAVATE
spend	ADMINISTER
phase	RE-ANALYZE
oxidize	OXIDIZE
signify	SIGNIFY
dysregulate	DYSREGULATE
obviate	OBVIATE
hold	FRACTIONATE
upslant	UPSLANT
disorder	DISORDER
place	JUXTAPOSE
expect	HOST
outweigh	OUTWEIGH
favor	GENERALISE
orient	ORIENT
deform	DEFORM
biotinylate	BIOTINYLATE
sever	SEVER
marker	MARKER
rate	BURN
sequence	SWITCH
name	PULL
compensate	HEAR
undergo	TRACK
slide	SQUARE
disperse	DISPERSE
cause	EXPLOIT
predict	ORCHESTRATE
change	PROTEIN
open	DENY
analyze	COLLATE
number	NUMBER
rescue	PATIENT
characterise	HOST
rise	RISE
visualise	VISUALISE
publish	PROJECT
sequencing	SUBCLON
overlook	OVERLOOK
recombine	RECOMBINE
rotate	ROTATE
stack	STACK
engender	ENGENDER
need	MOTIVATE
tear	TEAR
base	STAGE
clear	CLEAR
glycate	GLYCOSYLATE
type	NUCLEOTIDE
lyse	INFILTRATE
normalise	NORMALISE
make	BIOTINYLATE
search	ANNOTATE
impaired	IMPAIRED
address	OVERCOME
several	SEVERAL
equal	EQUAL
space	SPACE
refuse	COMMENCE
utilize	BIOTINYLATE
seed	FRACTIONATE
emphasise	EXEMPLIFY
bring	BRING
produce	BRIDGE
liberate	LIBERATE
exchange	BURY
derive	LABEL
calculate	PROJECT
excrete	SYNTHESISE
signal	SIGNAL
patient	PATIENT
return	ADMINISTER
heighten	HEIGHTEN
compromise	OVERRIDE
knockin	KNOCKIN
depolarize	FRACTIONATE
unravel	REEVALUATE
confine	CONFINE
fine-tune	FINE-TUNE
misfold	MISFOLD
innervate	TWITCH
come	COME
remove	OCCUPY
mouse	BAND
ensue	ENSUE
emphasize	ACCENTUATE
anchor	UBIQUITINATE
line	DILATE
pump	PUMP
include	COLLATE
balance	SURVIVE
knock	DIVERSIFY
allow	PROTEIN
grow	INFILTRATE
identify	SEEK
differ	PLOT
compound	COMPOUND
advocate	ADVOCATE
implant	IMPLANT
degrade	UBIQUITINATE
arrest	MATURE
wear	WEAR
abrogate	BLUNT
hear	HEAR
clarify	EVADE
improve	PROLONG
ligate	SUBCLON
utilise	TILE
attach	ATTACH
reconstitute	DEUBIQUITINATE
stabilize	CODIFY
originate	ORIGINATE
study	EXPLOIT
yield	CONTRADICT
activate	INACTIVATE
breed	TRAIN
disturb	IMPAIRED
snare	NUCLEATE
fold	UPSLANT
drop	DROP
resolve	DENY
depend	DEPEND
stall	STALL
stem	STEM
total	BURN
increase	PROLONG
refine	OCCUPY
offer	STAGE
manage	RESPOND
profile	DONATE
focus	STAGE
hybridize	TILE
encourage	SEEDLE
co-immunoprecipitate	CO-IMMUNOPRECIPITATE
elongate	ROUND
rule	REEVALUATE
hasten	HASTEN
miss	JUXTAPOSE
concentrate	STRIP
carry	SEEK
reactivate	REACTIVATE
define	BRIDGE
provide	SEEK
perpetuate	PERPETUATE
check	PLOT
fuel	FUEL
pinpoint	ANNOTATE
proliferate	INFILTRATE
design	BIOTINYLATE
would	WOULD
displace	DISPLACE
necessitate	TAILOR
size	SIZE
load	SIGN
relay	PROPAGATE
subtract	PLOT
reiterate	OBVIATE
hinder	HINDER
label	LABEL
worsen	IMPAIRED
dephosphorylate	COUPLE
boost	MAXIMISE
reproduce	RECONCILE
lessen	LESSEN
deny	DENY
control	ORCHESTRATE
feel	BURN
relapse	BURN
pronounce	PRONOUNCE
enter	VISIT
counter	COUNTER
moderate	OUTWEIGH
tile	TILE
estimate	PATIENT
result	HEAR
reduce	PROLONG
reverse	BIOTINYLATE
tolerate	ADMINISTER
date	COOPERATE
tease	TEASE
sift	SIFT
reconcile	RECONCILE
purify	BIOTINYLATE
mine	CONSULT
rationalize	RATIONALIZE
tailor	TAILOR
form	BRIDGE
charge	BURY
invoke	INVOKE
position	BURY
indicate	EXPLOIT
gyrate	GENERALISE
conflict	RECONCILE
plate	MATURE
eliminate	BLUNT
compile	SUBMIT
likely	LIKELY
fulfil	SPECULATE
fuse	SKIP
witness	WITNESS
denote	BRING
create	SURVIVE
face	FACE
conjugate	BIOTINYLATE
impose	FACE
repress	SWITCH
entail	ENTAIL
correspond	NECROTIZE
exceed	HEAR
survey	CONSULT
dissolve	DISSOLVE
damage	MATURE
program	SPEAK
burn	BURN
re-examine	RE-EXAMINE
illustrate	ACCENTUATE
occlude	OCCLUDE
sustain	SEEDLE
evolve	DIVERSIFY
anticipate	HASTEN
fill	ADMINISTER
verify	CAST
isolate	SWITCH
accumulate	SIGN
deposit	DEPOSIT
realize	REALIZE
trim	TRIM
exit	PERPETUATE
transplant	FRACTIONATE
inoculate	INOCULATE
sign	SIGN
synchronize	FRACTIONATE
distinct	DISTINCT
feed	FACE
nominate	NOMINATE
raise	BIOTINYLATE
collate	COLLATE
mediate	ORCHESTRATE
analyse	PATIENT
survive	SURVIVE
decline	DECLINE
list	HOST
vomit	BURN
elevated	ELEVATED
regenerate	TWITCH
preexist	NECROTIZE
halt	ASCEND
exercise	EXERCISE
mean	BRING
swallow	WALK
consider	TRACK
diagnose	SURVIVE
represent	EXPLOIT
confront	CONFRONT
select	VISIT
assume	ACCENTUATE
postulate	TRAIN
promise	DEEPEN
train	TRAIN
diminish	OVERRIDE
mention	MENTION
skew	SKEW
prepare	LABEL
assure	ASSURE
work	HEAR
manipulate	COLONIZE
combine	COLLATE
encompass	SWITCH
insert	SKIP
predispose	VISIT
prove	REEVALUATE
intermediate	INTERMEDIATE
ascertain	REEVALUATE
peak	PEAK
repeat	VISIT
demyelinate	DEVASTATE
specify	BRING
enclose	ENCLOSE
overexpress	CODIFY
risk	TITRATE
summarise	DEEPEN
seedle	SEEDLE
oppose	UNWIND
retard	SEEDLE
transmit	HOST
present	COLLATE
lengthen	LENGTHEN
strip	STRIP
side	SQUARE
initiate	MOTIVATE
read	HEAR
counsel	CONSULT
learn	HEAR
ingest	INGEST
conclude	UPSLANT
discount	DISCOUNT
depict	DEPICT
extend	MOTIVATE
smooth	INFILTRATE
endow	FRACTIONATE
pyrosequence	PYROSEQUENCE
blunt	BLUNT
couple	COUPLE
localise	LOCALISE
circumvent	OVERCOME
recruit	CODIFY
substitute	BRANCH
lower	BRING
distribute	DISTRIBUTE
suffer	GENERALISE
match	JUXTAPOSE
embrace	EMBRACE
depress	DEPRESS
climb	WALK
help	CONSULT
optimize	SALT
secure	SECURE
spot	SPOT
attract	FRACTIONATE
upregulate	DIVERSIFY
enjoy	ENJOY
manufacture	MANUFACTURE
glutamate	GLUTAMATE
plan	TAILOR
simulate	TRAIN
revise	SUBMIT
implicate	CODIFY
protrude	PROTRUDE
dictate	DICTATE
thicken	DEFORM
employ	BIOTINYLATE
expedite	EXPEDITE
assemble	PULL
conceive	MOTIVATE
subject	DONATE
unfold	EVADE
incubate	INFILTRATE
interfere	INTERFERE
maintain	PROTEIN
degenerate	MATURE
diverge	DIVERGE
omit	OMIT
regress	REGRESS
inherit	TRACK
vanish	DEVASTATE
contaminate	MATURE
remain	REMAIN
conduct	CONTRADICT
grant	GRANT
swim	TWITCH
polarize	POLARIZE
entitle	ENTITLE
asphyxiate	ASPHYXIATE
clot	CLOT
operate	OPERATE
devastate	DEVASTATE
deliver	PULL
ubiquitinate	UBIQUITINATE
demand	DEMAND
merit	OMIT
human	PAIR
rename	RENAME
give	CONTRADICT
simplify	SALT
over-express	OVER-EXPRESS
prescribe	ADMINISTER
foster	DEEPEN
infect	INFILTRATE
divert	DIVERT
contain	SEEK
withstand	SURVIVE
trap	TRAP
enlarge	ENLARGE
note	DENY
infiltrate	INFILTRATE
condition	CONDITION
outperform	SALT
destroy	IMPAIRED
leverage	RE-ANALYZE
standardize	STANDARDIZE
superimpose	SUPERIMPOSE
interact	CODIFY
account	ACCOUNT
introduce	INACTIVATE
phosphorylate	CODIFY
probe	REEVALUATE
branch	BRANCH
pass	SURVIVE
coordinate	MOTIVATE
describe	CONTRADICT
ablate	UNWIND
approximate	APPROXIMATE
ensure	PLOT
might	MIGHT
maximize	BRING
import	IMPORT
regard	ACCENTUATE
potentiate	OVERRIDE
outnumber	OUTNUMBER
mutagenize	MUTAGENIZE
consult	CONSULT
attack	ATTACK
perceive	PERCEIVE
quantitate	INGEST
strengthen	REEVALUATE
alleviate	DENY
apply	SURVIVE
cool	COOL
recover	HOST
bias	RECONCILE
co-write	CO-WRITE
cleave	UBIQUITINATE
approve	MOTIVATE
leave	CAST
repair	AGGRAVATE
contract	CONTRACT
substantiate	RECONCILE
expose	INFILTRATE
disable	DEVASTATE
corroborate	CAST
crosslink	CROSSLINK
appear	LENGTHEN
recommend	TAILOR
acquire	OVERCOME
exist	SUBMIT
cross	IMPAIRED
limit	BRING
subdivide	BURN
narrow	OCCUPY
neuroimage	RECONCILE
inactivate	INACTIVATE
elute	SPIN
correct	OVERCOME
progress	DEVASTATE
channel	CHANNEL
spare	TWITCH
discern	DISCERN
resist	RESIST
copy	ANNOTATE
answer	APPROACH
tabulate	TABULATE
impair	PROTEIN
migrate	GENERALISE
perform	CONTRADICT
house	HOUSE
correlate	PROJECT
adjust	PLOT
revisit	REVISIT
show	PROLONG
justify	OVERSEE
record	DENY
discontinue	TAILOR
report	SEEK
advise	ADVISE
gauge	GAUGE
meet	FACE
save	THREATEN
precipitate	CROSS-REACT
single	NUCLEOTIDE
commence	COMMENCE
dilate	DILATE
co-transfect	LABEL
phenocopy	PHENOCOPY
weigh	WEIGH
encode	COLLATE
guide	DIVERSIFY
construct	SIGN
evidence	ASPHYXIATE
underpin	SEEDLE
absorb	CAST
merge	EXTRAPOLATE
restrain	SEEDLE
transfer	MUTAGENIZE
monitor	BRING
truncate	CODIFY
relax	STRIP
imply	ACCENTUATE
skip	SKIP
influence	PROLONG
function	FRACTIONATE
gaze	GAZE
rest	HEAD
acetylate	ACETYLATE
enforce	ENFORCE
fractionate	FRACTIONATE
coin	ASPHYXIATE
titrate	TITRATE
weight	WEIGHT
unveil	ILLUMINATE
re-sequence	RE-SEQUENCE
obscure	OBSCURE
establish	EVADE
scan	SKIP
favour	TRAIN
pair	PAIR
host	HOST
illuminate	ILLUMINATE
clone	TRACK
recreate	RECREATE
elaborate	ELABORATE
follow	SURVIVE
donate	DONATE
catalys	WALK
necrotize	NECROTIZE
deduce	HOMOGENIZE
admit	ADMIT
translocate	TRANSLOCATE
send	ADMINISTER
interpret	CAST
lead	DILATE
precede	GENERALISE
query	CONSULT
exhibit	PROLONG
benefit	BURN
flatten	FLATTEN
compute	BRING
reprogram	MATURE
associate	UBIQUITINATE
neighbor	OVERLIE
align	DIVERSIFY
mask	OVERRIDE
predate	HERALD
deaminate	DEAMINATE
transport	PULL
involve	INACTIVATE
view	VIEW
throw	CAST
replenish	REPLENISH
reject	TRAIN
sense	COUPLE
colonize	COLONIZE
alkylate	ALKYLATE
juxtapose	JUXTAPOSE
catch	CATCH
splice	SKIP
protein	PROTEIN
affect	PROLONG
proofread	UNWIND
range	WALK
express	INACTIVATE
satisfy	CONSULT
distort	DISTORT
demarcate	DEMARCATE
dilute	DONATE
recycle	RECYCLE
belong	BELONG
counteract	OVERRIDE
classify	STAGE
underscore	ACCENTUATE
split	DONATE
circulate	LABEL
determine	EXPLOIT
mapping	MAPPING
aged	ADMINISTER
harvest	MATURE
hyperpolarize	HYPERPOLARIZE
generate	EXPLOIT
accompany	HEAR
extract	PROJECT
overlie	OVERLIE
excise	SKIP
constrain	CONSTRAIN
evoke	EVADE
trigger	BLUNT
rank	ANNOTATE
waste	DEVASTATE
scale	SCALE
resequence	SKIP
adapt	SALT
glycosylate	GLYCOSYLATE
investigate	SEEK
disrupt	BRIDGE
ionize	IONIZE
bleed	DENY
mate	KNOCKIN
endorse	ENDORSE
prioritize	JUXTAPOSE
designate	OVERLIE
deserve	OMIT
begin	TAILOR
guarantee	GUARANTEE
collapse	SALT
mimic	ACCENTUATE
redefine	REDEFINE
release	UBIQUITINATE
stop	TAILOR
quantify	ACCENTUATE
occur	ANNOTATE
differentiate	SIGN
surround	OCCUPY
invite	INVITE
receptor	RECEPTOR
build	GENERALISE
organize	DEFORM
conserve	SUBMIT
reexamine	REEXAMINE
coexist	DILATE
gather	SUBMIT
eradicate	ERADICATE
related	RELATED
regain	WALK
examine	CONTRADICT
transduce	INFILTRATE
rectify	DILATE
subserve	DETERIORATE
alternate	ALTERNATE
scramble	SCRAMBLE
immunoprecipitate	PULL
diffuse	DIFFUSE
fight	CLEAR
submit	SUBMIT
obtain	COLLATE
annotate	ANNOTATE
demethylate	DEMETHYLATE
drive	BLUNT
herald	HERALD
propagate	PROPAGATE
register	REGISTER
transactivate	JUXTAPOSE
project	PROJECT
codify	CODIFY
last	LAST
advance	HINDER
aggregate	AGGREGATE
surpass	APPROACH
sort	PULL
disentangle	OUTWEIGH
high-frequency	HEAR
look	LOOK
down-regulate	ANNOTATE
round	ROUND
unmask	UNMASK
phenotype	PHENOTYPE
swap	SWAP
accommodate	BURY
achieve	BLUNT
speculate	SPECULATE
comprehend	COMPREHEND
coimmunoprecipitate	COIMMUNOPRECIPITATE
exacerbate	GENERALISE
downslant	UPSLANT
attend	VISIT
lock	OXIDIZE
quit	QUIT
average	PLOT
motivate	MOTIVATE
decorate	DECORATE
populate	POPULATE
reference	REFERENCE
deacetylate	ACETYLATE
mutation	MUTATION
draft	SUBMIT
visualize	LABEL
hydrolyze	ACETYLATE
suggest	CONTRADICT
assess	BRIDGE
inject	STAGE
relate	RECONCILE
slow	HINDER
explain	TRACK
minimise	MINIMISE
ankylose	ANKYLOSE
optimise	OPTIMISE
tether	TETHER
start	SKIP
deregulate	SHUT
accentuate	ACCENTUATE
deubiquitinate	DEUBIQUITINATE
approach	APPROACH
catalyze	HINDER
supplement	INOCULATE
inhabit	COLONIZE
validate	STAGE
walk	WALK
border	BORDER
knockdown	KNOCKDOWN
afford	AFFORD
cross-react	CROSS-REACT
could	COULD
descend	DILATE
infer	REEVALUATE
overestimate	OVERESTIMATE
funnel	ADMINISTER
promote	PROLONG
spread	SPREAD
collect	COLLATE
consume	ADMINISTER
echo	ECHO
close	DILATE
lack	INACTIVATE
stain	INFILTRATE
cover	SWITCH
delimit	DEMARCATE
consistent	CONSISTENT
elude	ELUDE
coexpress	COUPLE
overwhelm	OVERWHELM
co-exist	CO-EXIST
live	MATURE
choose	ANNOTATE
capture	ANNOTATE
restricted	OVERSEE
seek	SEEK
residue	RESIDUE
write	SIGN
disseminate	CLEAR
concern	HOST
digest	SUBCLON
persist	PERSIST
drink	INGEST
contradict	CONTRADICT
wash	PROLONG
shut	SHUT
pick	AGGRAVATE
converge	CONVERGE
characterize	INACTIVATE
automate	AUTOMATE
attribute	ATTRIBUTE
bury	BURY
prompt	HINDER
outbreed	KNOCKIN
generalise	GENERALISE
negate	OBVIATE
melt	PULL
request	ELUDE
link	OCCUPY
flank	OCCUPY
finish	FINISH
contribute	PROJECT
fast	PLOT
gate	DILATE
co-express	CROSS-REACT
smoke	SMOKE
hydroxylate	DEAMINATE
diversify	DIVERSIFY
orchestrate	ORCHESTRATE
internalize	INTERNALIZE
head	HEAD
attain	APPROACH
ascribe	ASCRIBE
suspect	DILATE
trace	DENY
regulate	PROLONG
affirm	AFFIRM
dominate	ENLARGE
confer	PROTEIN
fail	TAILOR
denature	SALT
attenuate	BLUNT
exclude	TRACK
draw	RECONCILE
support	COLLATE
nitrocellulose	OVERLIE
incorporate	CAST
important	IMPORTANT
execute	ACCOMPLISH
cross-link	CROSS-LINK
model	OVERRIDE
challenge	TRAIN
access	RE-ANALYZE
provoke	AGGRAVATE
inbreed	SPREAD
homogenize	HOMOGENIZE
occupy	OCCUPY
find	SEEK
outline	WALK
prime	PRIME
facilitate	PROTEIN
prefer	PREFER
imprint	OVERLIE
silence	OVERLIE
group	RESPOND
ripple	DEVASTATE
derepress	DEREPRESS
dissect	REEVALUATE
downregulate	DIVERSIFY
supervise	PULL
mark	LABEL
gene	NUCLEOTIDE
interview	BURN
mitigate	OVERRIDE
assist	DEEPEN
pose	OVERCOME
notice	HEAR
count	PROJECT
recall	RECALL
keep	MATURE
maximise	MAXIMISE
bind	BRIDGE
unwind	UNWIND
discriminate	BURN
datum	DATUM
order	SQUARE
bear	INACTIVATE
immunize	KNOCKIN
catalyse	COOL
prioritise	PRIORITISE
alert	ALERT
communicate	COMMUNICATE
protect	SURVIVE
cite	CITE
elicit	BLUNT
abolish	BRIDGE
boil	DONATE
review	MOTIVATE
avoid	EVADE
stimulate	ORCHESTRATE
span	BRIDGE
propose	EVADE
spin	SPIN
reestablish	REESTABLISH
prohibit	PROHIBIT
immobilize	IMMOBILIZE
think	THINK
take	PATIENT
inhibit	ORCHESTRATE
recognize	CODIFY
widen	ENLARGE
partition	PARTITION
formulate	TRAIN
culture	PATIENT
nucleotide	NUCLEOTIDE
discard	DISCARD
exon	EXON
transfect	SURVIVE
dissociate	INOCULATE
code	SWITCH
preclude	DENY
penetrate	DEFORM
re-analyze	RE-ANALYZE
afflict	THANK
revolutionize	DEEPEN
personalize	TAILOR
sequester	UBIQUITINATE
believe	BELIEVE
display	EXPLOIT
categorize	DILATE
evade	EVADE
export	EXPORT
fluctuate	FLUCTUATE
observe	EXPLOIT
prevent	ORCHESTRATE
remodel	PULL
disclose	HOST
combat	DEVASTATE
located	OVERLIE
speak	SPEAK
plot	PLOT
kill	INFILTRATE
claim	CLAIM
relieve	DENY
bend	BEND
contact	CONSULT
rearrange	LOCALISE
shape	ENLARGE
obstruct	OBSTRUCT
disregard	DISREGARD
perturb	HINDER
buffer	BUFFER
intercross	KNOCKIN
invade	CLEAR
backcross	ADMINISTER
envision	ENVISION
cure	DEVASTATE
enhance	ORCHESTRATE
visit	VISIT
vary	BRING
scatter	TWITCH
interrogate	OVERLIE
switch	SWITCH
consist	SKIP
render	UBIQUITINATE
functional	FUNCTIONAL
parallel	RECONCILE
exert	PATIENT
tail	SQUARE
individualize	TAILOR
complement	OVERCOME
feature	NECROTIZE
bristle	SEEDLE
square	SQUARE
genotype	VISIT
cotransfect	LABEL
replicate	CONTRADICT
underlie	TRACK
demonstrate	EXPLOIT
cross-complement	CROSS-COMPLEMENT
gain	CAST
lose	BLUNT
emerge	DEEPEN
test	CONTRADICT
commit	COMMIT
intensify	INTENSIFY
mirror	MIRROR
shorten	WALK
